11111111111
1EP1011C111
11111111111